Inf	Inf	19	Inf	Inf	Inf	Inf	Inf	Inf	Inf	Inf	58	Inf	Inf	Inf	Inf	Inf	Inf	Inf	Inf	Inf	Inf	Inf	Inf	Inf	Inf	Inf	Inf	Inf	66	Inf	Inf	Inf	Inf	Inf	Inf	Inf	32	Inf	Inf	Inf	Inf	Inf	Inf	Inf	Inf	Inf	Inf	Inf	Inf
898	876	718	895	864	854	837	857	826	836	842	475	840	843	829	860	866	851	841	808	828	875	826	808	843	815	791	782	807	376	784	790	824	823	814	831	816	130	820	812	795	791	787	798	791	811	786	771	761	802
Inf	Inf	15	Inf	Inf	Inf	Inf	Inf	Inf	Inf	Inf	Inf	57	Inf	Inf	Inf	Inf	Inf	Inf	Inf	Inf	Inf	Inf	Inf	Inf	15	Inf	Inf	47	52	Inf	Inf	Inf	Inf	Inf	Inf	Inf	30	Inf	Inf	Inf	Inf	Inf	Inf	Inf	Inf	Inf	Inf	Inf	Inf
865	899	48	895	884	889	899	888	874	908	892	819	488	891	939	616	678	662	688	661	679	666	694	691	642	254	621	680	393	317	679	687	678	631	679	685	674	463	678	680	651	672	664	653	660	645	660	678	639	687
Inf	Inf	Inf	Inf	Inf	Inf	Inf	Inf	Inf	Inf	Inf	Inf	Inf	Inf	Inf	Inf	Inf	Inf	Inf	Inf	Inf	Inf	Inf	Inf	Inf	Inf	Inf	Inf	Inf	Inf	Inf	Inf	Inf	Inf	Inf	Inf	Inf	Inf	Inf	Inf	Inf	Inf	Inf	Inf	Inf	Inf	Inf	Inf	Inf	Inf
357	332	300	319	348	329	328	325	349	325	312	337	269	348	300	304	318	320	337	303	287	349	328	317	348	316	338	322	326	303	319	338	327	327	299	333	324	329	344	325	351	329	371	340	312	342	338	327	331	303
Inf	Inf	Inf	Inf	Inf	Inf	Inf	Inf	Inf	Inf	Inf	Inf	Inf	Inf	Inf	Inf	Inf	Inf	Inf	Inf	Inf	Inf	Inf	Inf	Inf	Inf	Inf	Inf	Inf	Inf	Inf	Inf	Inf	Inf	Inf	Inf	Inf	Inf	Inf	Inf	Inf	Inf	Inf	Inf	Inf	Inf	Inf	Inf	Inf	Inf
635	680	669	684	703	695	671	661	664	655	666	666	676	644	674	670	662	655	664	669	626	660	658	656	644	657	675	643	672	658	643	665	625	654	589	548	575	645	565	595	651	678	681	679	655	652	670	586	647	565
Inf	Inf	Inf	Inf	Inf	Inf	Inf	Inf	Inf	Inf	Inf	Inf	Inf	Inf	Inf	Inf	Inf	Inf	Inf	Inf	Inf	Inf	Inf	Inf	Inf	Inf	Inf	Inf	Inf	Inf	Inf	Inf	Inf	Inf	Inf	Inf	Inf	Inf	Inf	Inf	Inf	Inf	Inf	Inf	Inf	Inf	Inf	Inf	Inf	Inf
714	721	708	698	711	702	709	684	709	693	681	704	716	707	713	691	692	675	672	694	691	682	646	672	682	649	655	681	653	676	685	677	617	620	692	689	691	670	695	688	687	682	664	688	697	687	660	691	690	689
Inf	Inf	Inf	Inf	Inf	Inf	Inf	Inf	Inf	Inf	Inf	Inf	Inf	Inf	Inf	Inf	Inf	Inf	Inf	Inf	Inf	Inf	Inf	Inf	Inf	Inf	Inf	Inf	Inf	Inf	Inf	Inf	Inf	Inf	Inf	Inf	Inf	Inf	Inf	Inf	Inf	Inf	Inf	Inf	Inf	Inf	Inf	Inf	Inf	Inf
187	193	202	201	188	201	191	188	191	198	187	177	174	248	232	242	243	236	254	234	251	246	237	243	253	234	244	241	225	237	235	234	230	238	232	224	203	233	241	238	245	228	238	237	237	236	237	246	234	243
Inf	Inf	Inf	Inf	Inf	Inf	Inf	Inf	Inf	Inf	Inf	Inf	Inf	Inf	Inf	Inf	Inf	Inf	Inf	Inf	Inf	Inf	Inf	Inf	Inf	Inf	Inf	Inf	Inf	Inf	Inf	Inf	Inf	Inf	Inf	Inf	Inf	Inf	Inf	Inf	Inf	Inf	Inf	Inf	Inf	Inf	Inf	Inf	Inf	Inf
852	860	850	882	837	836	846	831	806	831	858	791	907	701	663	643	656	679	651	635	672	666	668	651	632	633	641	645	648	649	619	630	626	637	626	650	639	650	659	632	656	661	636	602	652	596	584	672	630	652
Inf	Inf	Inf	Inf	Inf	Inf	Inf	Inf	74	Inf	Inf	Inf	Inf	Inf	74	Inf	Inf	Inf	Inf	36	Inf	Inf	Inf	Inf	Inf	Inf	Inf	Inf	Inf	48	Inf	Inf	Inf	Inf	Inf	Inf	Inf	Inf	Inf	Inf	Inf	Inf	Inf	Inf	Inf	Inf	Inf	Inf	Inf	Inf
692	699	659	661	700	684	696	692	556	684	664	694	679	686	477	700	703	692	713	227	692	671	705	701	706	670	708	701	702	518	703	700	703	691	693	684	712	678	650	678	670	673	641	686	668	658	693	686	687	678
Inf	Inf	Inf	Inf	Inf	Inf	Inf	Inf	Inf	Inf	Inf	Inf	Inf	Inf	Inf	Inf	Inf	Inf	Inf	Inf	Inf	Inf	Inf	Inf	Inf	Inf	Inf	Inf	Inf	Inf	Inf	Inf	Inf	Inf	Inf	Inf	Inf	Inf	Inf	Inf	Inf	Inf	Inf	Inf	Inf	Inf	Inf	Inf	Inf	Inf
575	683	652	631	636	651	686	652	663	659	630	640	682	722	668	696	711	692	694	670	664	695	701	676	685	698	633	602	682	718	702	679	708	707	712	596	663	661	647	663	683	663	680	704	640	701	705	670	644	659
Inf	Inf	Inf	Inf	Inf	Inf	Inf	Inf	Inf	Inf	Inf	Inf	Inf	Inf	Inf	Inf	Inf	Inf	Inf	Inf	Inf	Inf	Inf	Inf	Inf	Inf	Inf	Inf	Inf	Inf	Inf	Inf	Inf	Inf	Inf	Inf	Inf	Inf	Inf	Inf	Inf	Inf	Inf	Inf	Inf	Inf	Inf	Inf	Inf	Inf
704	671	709	690	708	707	683	701	710	644	692	692	690	693	678	686	696	687	696	692	656	694	685	667	683	693	635	687	688	651	688	687	665	695	707	705	689	700	707	698	688	686	706	696	705	678	686	677	681	626
Inf	Inf	Inf	Inf	Inf	Inf	Inf	Inf	Inf	Inf	Inf	Inf	Inf	Inf	Inf	Inf	Inf	Inf	Inf	Inf	Inf	Inf	Inf	Inf	Inf	Inf	Inf	Inf	Inf	Inf	Inf	Inf	Inf	Inf	Inf	Inf	Inf	Inf	Inf	Inf	Inf	Inf	Inf	Inf	Inf	Inf	Inf	Inf	Inf	Inf
234	240	255	248	244	248	236	232	242	252	234	226	227	241	228	237	238	232	249	237	252	247	243	250	254	237	253	259	243	255	248	244	244	255	245	243	220	240	244	239	246	231	242	243	245	239	241	253	234	248
Inf	Inf	Inf	Inf	Inf	Inf	Inf	Inf	Inf	Inf	Inf	Inf	Inf	Inf	Inf	Inf	Inf	Inf	Inf	Inf	Inf	Inf	Inf	Inf	Inf	Inf	Inf	Inf	Inf	Inf	Inf	Inf	Inf	Inf	Inf	Inf	Inf	Inf	Inf	Inf	Inf	Inf	Inf	Inf	Inf	Inf	Inf	Inf	Inf	Inf
674	656	680	695	694	698	689	700	691	697	701	698	659	673	698	694	691	654	688	688	675	691	668	689	695	695	684	689	684	971	938	942	937	930	909	908	909	914	903	920	898	897	895	902	892	859	881	899	877	863
Inf	Inf	Inf	Inf	Inf	Inf	Inf	Inf	Inf	Inf	Inf	Inf	Inf	Inf	Inf	Inf	Inf	Inf	Inf	Inf	Inf	Inf	Inf	Inf	Inf	Inf	Inf	Inf	Inf	Inf	Inf	Inf	Inf	Inf	Inf	Inf	Inf	Inf	Inf	Inf	Inf	Inf	Inf	Inf	Inf	Inf	Inf	Inf	Inf	Inf
882	889	851	865	905	907	877	954	688	688	683	693	701	695	679	693	650	667	669	682	655	665	629	643	664	616	640	647	642	672	717	700	694	707	708	715	698	695	686	713	637	708	692	688	714	718	713	683	705	698
Inf	Inf	Inf	Inf	Inf	Inf	Inf	Inf	Inf	Inf	Inf	Inf	Inf	Inf	Inf	Inf	Inf	Inf	Inf	Inf	Inf	Inf	Inf	Inf	Inf	Inf	Inf	Inf	Inf	Inf	Inf	Inf	Inf	Inf	Inf	Inf	Inf	Inf	Inf	Inf	Inf	Inf	Inf	Inf	Inf	Inf	Inf	Inf	Inf	Inf
695	645	712	701	689	57	697	717	671	709	699	680	675	732	676	708	705	714	701	686	682	725	729	717	719	703	689	706	708	731	740	740	732	742	741	759	753	741	754	746	732	744	741	753	758	727	733	750	746	738
Inf	Inf	Inf	Inf	Inf	Inf	Inf	Inf	Inf	Inf	Inf	Inf	Inf	Inf	Inf	Inf	Inf	Inf	Inf	Inf	Inf	Inf	Inf	Inf	Inf	Inf	Inf	Inf	Inf	Inf	Inf	Inf	Inf	Inf	Inf	Inf	Inf	Inf	Inf	Inf	Inf	Inf	Inf	Inf	Inf	Inf	Inf	Inf	Inf	Inf
563	625	611	595	574	602	598	620	624	602	566	613	548	564	612	620	623	627	606	582	585	555	611	571	618	622	605	586	566	617	580	609	583	559	624	546	554	593	623	553	607	572	593	597	543	612	608	566	276	563
Inf	Inf	Inf	Inf	Inf	Inf	Inf	Inf	Inf	Inf	Inf	Inf	Inf	Inf	Inf	Inf	Inf	Inf	Inf	Inf	Inf	Inf	Inf	Inf	Inf	Inf	Inf	Inf	Inf	Inf	Inf	Inf	Inf	Inf	Inf	Inf	Inf	Inf	Inf	Inf	Inf	Inf	Inf	Inf	Inf	Inf	Inf	Inf	Inf	Inf
246	250	254	243	249	253	242	329	319	322	308	294	303	307	285	301	301	292	313	291	309	303	291	304	311	296	304	311	292	308	304	308	315	322	309	314	280	299	299	302	311	296	304	300	302	301	296	308	291	304
Inf	Inf	17	Inf	Inf	Inf	Inf	Inf	Inf	Inf	Inf	52	Inf	Inf	Inf	Inf	Inf	Inf	Inf	Inf	Inf	Inf	Inf	Inf	Inf	15	Inf	Inf	49	62	Inf	Inf	Inf	Inf	Inf	Inf	Inf	Inf	Inf	Inf	Inf	Inf	Inf	46	Inf	Inf	Inf	Inf	Inf	57
921	836	316	913	910	857	913	943	931	931	944	464	949	920	937	898	898	890	933	930	899	945	716	696	709	89	662	692	619	406	656	698	679	701	694	697	678	635	670	659	669	679	665	398	669	631	652	698	624	633
Inf	Inf	Inf	Inf	Inf	Inf	Inf	50	Inf	Inf	Inf	Inf	Inf	Inf	Inf	Inf	Inf	Inf	Inf	Inf	Inf	Inf	Inf	Inf	Inf	Inf	Inf	Inf	Inf	Inf	Inf	Inf	Inf	Inf	Inf	Inf	Inf	Inf	Inf	Inf	Inf	Inf	Inf	Inf	Inf	Inf	Inf	Inf	Inf	Inf
692	690	353	724	735	720	738	373	709	740	722	735	713	739	731	755	761	721	748	746	746	730	740	731	712	672	742	739	706	734	736	724	712	16	721	755	732	752	737	743	728	748	741	756	743	724	726	747	746	751
Inf	Inf	Inf	Inf	Inf	Inf	Inf	Inf	Inf	Inf	Inf	Inf	Inf	Inf	Inf	Inf	Inf	Inf	Inf	Inf	Inf	Inf	Inf	Inf	Inf	Inf	Inf	Inf	Inf	Inf	Inf	Inf	Inf	Inf	Inf	Inf	Inf	Inf	Inf	Inf	Inf	Inf	Inf	Inf	Inf	Inf	Inf	Inf	Inf	Inf
722	754	714	721	685	745	751	739	754	745	734	734	725	741	715	743	739	751	723	717	693	747	711	691	702	736	532	710	678	693	698	694	689	709	670	686	646	734	737	748	712	726	684	729	729	754	728	731	706	749
Inf	18	15	Inf	Inf	Inf	Inf	46	Inf	Inf	Inf	Inf	Inf	Inf	Inf	Inf	Inf	Inf	Inf	68	Inf	Inf	Inf	Inf	Inf	19	81	Inf	Inf	Inf	Inf	Inf	Inf	Inf	Inf	Inf	Inf	34	Inf	Inf	Inf	Inf	Inf	Inf	Inf	Inf	Inf	Inf	Inf	Inf
746	152	49	746	750	750	744	276	715	743	728	741	749	715	742	748	754	750	752	266	744	748	751	748	753	262	652	750	734	722	733	725	732	731	737	740	736	333	703	719	724	680	726	720	728	717	709	729	724	724
Inf	Inf	Inf	Inf	Inf	Inf	Inf	Inf	Inf	Inf	Inf	Inf	Inf	Inf	Inf	Inf	Inf	Inf	Inf	Inf	Inf	Inf	Inf	Inf	Inf	Inf	Inf	Inf	Inf	Inf	Inf	Inf	Inf	Inf	Inf	Inf	Inf	Inf	Inf	Inf	Inf	Inf	Inf	Inf	Inf	Inf	Inf	Inf	Inf	Inf
713	732	704	727	743	744	673	745	718	730	728	722	726	697	714	726	718	719	726	712	727	668	721	718	720	710	717	713	724	705	704	718	722	649	721	713	748	735	749	728	728	744	728	745	712	694	751	712	741	717
Inf	Inf	13	Inf	Inf	Inf	Inf	Inf	72	Inf	Inf	56	Inf	Inf	Inf	Inf	Inf	Inf	Inf	38	Inf	Inf	Inf	Inf	102	25	89	Inf	47	54	Inf	Inf	Inf	Inf	Inf	Inf	Inf	32	Inf	Inf	Inf	Inf	Inf	42	Inf	Inf	Inf	Inf	Inf	83
722	748	34	723	720	715	732	702	700	724	729	536	720	720	728	721	721	728	728	1043	1037	1016	1029	979	977	111	794	984	389	370	969	973	984	955	952	971	981	390	953	975	929	952	947	203	940	939	922	943	911	806
Inf	Inf	Inf	Inf	Inf	Inf	Inf	Inf	Inf	Inf	Inf	Inf	Inf	Inf	Inf	Inf	Inf	Inf	Inf	Inf	Inf	Inf	Inf	Inf	Inf	Inf	Inf	Inf	Inf	Inf	Inf	Inf	Inf	Inf	Inf	Inf	Inf	Inf	Inf	Inf	Inf	Inf	Inf	Inf	Inf	Inf	Inf	Inf	Inf	Inf
927	716	732	668	657	713	655	717	640	595	593	618	576	683	529	672	587	582	591	712	690	686	641	687	681	683	683	636	726	641	704	679	379	429	413	398	369	365	379	381	370	351	393	404	340	330	392	359	415	471
