86	84	116	98	124	78	86	120	110	90	90	120	124	116	110	128	114	122	78	80	122	108	114	116	132	96	112	132	104	100	104	126	94	92	58	90	110	92	118	134	94	102	84	120	108	82	104	94	110	110
1453	880	1129	519	1801	918	1440	1363	1649	1208	252	1330	761	1422	845	1138	1142	1005	283	1637	1186	698	1226	1008	812	579	828	649	1070	1062	1103	1647	1829	731	599	1451	954	1119	679	841	544	2019	544	1605	970	1636	849	981	1327	1562
86	84	116	98	124	78	86	120	110	90	90	120	124	116	110	128	114	122	78	80	122	108	114	116	132	96	112	132	104	100	104	126	94	92	58	90	110	92	118	134	94	102	84	120	108	82	104	94	110	110
474	381	483	773	162	459	367	733	157	629	202	230	425	873	327	492	415	856	210	367	323	384	917	295	858	1146	179	1444	258	592	660	1584	912	459	98	374	362	388	1100	1107	470	616	325	326	953	449	277	739	573	889
86	84	116	98	124	78	86	120	110	90	90	120	124	116	110	128	114	122	78	80	122	108	114	116	132	96	112	132	104	100	104	126	94	92	58	90	110	92	118	134	94	102	84	120	108	82	104	94	110	110
1453	880	1129	519	1801	918	1440	1363	1649	1208	252	1330	761	1422	845	1138	1142	1005	283	1637	1186	698	1226	1008	812	579	828	649	1070	1062	1103	1647	1829	731	599	1451	954	1119	679	841	544	2019	544	1605	970	1636	849	981	1327	1562
86	84	116	98	124	78	86	120	110	90	90	120	124	116	110	128	114	122	78	80	122	108	114	116	132	96	112	132	104	100	104	126	94	92	58	90	110	92	118	134	94	102	84	120	108	82	104	94	110	110
86	84	116	98	124	78	86	120	110	90	90	120	124	116	110	128	114	122	78	80	122	108	114	116	132	96	112	132	104	100	104	126	94	92	58	90	110	92	118	134	94	102	84	120	108	82	104	94	110	110
