58	58	36	54	36	48	36	52	60	38	50	48	50	54	36	42	46	50	40	28	54	52	48	58	42	32	36	46	52	44	46	48	46	32	58	50	20	52	54	52	34	40	62	30	50	54	56	58	32	52
307	395	226	301	284	137	171	121	291	365	438	425	324	323	95	285	104	116	261	52	253	228	415	291	96	131	166	495	184	100	216	153	202	454	279	261	151	518	450	137	56	124	369	488	200	513	363	411	327	312
58	58	36	54	36	48	36	52	60	38	50	48	50	54	36	42	46	50	40	28	54	52	48	58	42	32	36	46	52	44	46	48	46	32	58	50	20	52	54	52	34	40	62	30	50	54	56	58	32	52
258	317	104	145	106	72	45	92	95	115	239	76	69	82	47	197	83	268	223	122	153	94	80	121	176	118	76	406	280	156	70	94	57	38	145	67	25	68	159	118	49	74	130	52	126	118	340	175	67	98
58	58	36	54	36	48	36	52	60	38	50	48	50	54	36	42	46	50	40	28	54	52	48	58	42	32	36	46	52	44	46	48	46	32	58	50	20	52	54	52	34	40	62	30	50	54	56	58	32	52
307	395	226	301	284	137	171	121	291	365	438	425	324	323	95	285	104	116	261	52	253	228	415	291	96	131	166	495	184	100	216	153	202	454	279	261	151	518	450	137	56	124	369	488	200	513	363	411	327	312
58	58	36	54	36	48	36	52	60	38	50	48	50	54	36	42	46	50	40	28	54	52	48	58	42	32	36	46	52	44	46	48	46	32	58	50	20	52	54	52	34	40	62	30	50	54	56	58	32	52
58	58	36	54	36	48	36	52	60	38	50	48	50	54	36	42	46	50	40	28	54	52	48	58	42	32	36	46	52	44	46	48	46	32	58	50	20	52	54	52	34	40	62	30	50	54	56	58	32	52
