58	58	36	54	36	48	36	52	60	38	50	48	50	54	36	42	46	50	40	28	54	52	48	58	42	32	36	46	52	44	46	48	46	32	58	50	20	52	54	52	34	40	62	30	50	54	56	58	32	52
542	527	449	484	500	511	521	512	510	463	541	542	526	510	517	482	526	533	527	351	515	526	533	522	527	455	501	459	519	481	511	527	491	488	527	509	227	502	527	541	323	510	525	324	495	507	526	523	428	500
58	58	36	54	36	48	36	52	60	38	50	48	50	54	36	42	46	50	40	28	54	52	48	58	42	32	36	46	52	44	46	48	46	32	58	50	20	52	54	52	34	40	62	30	50	54	56	58	32	52
405	352	200	301	216	268	226	419	440	191	383	366	354	375	206	239	327	289	214	94	301	404	313	357	313	182	193	233	473	272	300	392	240	184	383	283	54	267	412	354	140	273	431	112	367	304	412	345	143	300
58	58	36	54	36	48	36	52	60	38	50	48	50	54	36	42	46	50	40	28	54	52	48	58	42	32	36	46	52	44	46	48	46	32	58	50	20	52	54	52	34	40	62	30	50	54	56	58	32	52
542	527	449	484	500	511	521	512	510	463	541	542	526	510	517	482	526	533	527	351	515	526	533	522	527	455	501	459	519	481	511	527	491	488	527	509	227	502	527	541	323	510	525	324	495	507	526	523	428	500
58	58	36	54	36	48	36	52	60	38	50	48	50	54	36	42	46	50	40	28	54	52	48	58	42	32	36	46	52	44	46	48	46	32	58	50	20	52	54	52	34	40	62	30	50	54	56	58	32	52
59	59	37	55	37	49	37	53	61	39	51	49	51	55	37	43	47	51	41	29	55	53	49	59	43	33	37	47	53	45	47	49	47	33	59	51	21	53	55	53	35	41	63	31	51	55	57	59	33	53
