24	16	20	26	20	16	12	20	20	14	16	16	24	22	24	24	28	20	20	18	16	28	36	28	30	26	24	34	36	24	26	38	30	30	18	20	24	20	22	12	26	24	28	20	26	34	16	26	32	14
134	132	100	138	118	129	92	106	123	93	133	110	142	135	107	134	135	126	134	117	124	135	135	141	142	126	122	134	133	143	127	134	135	143	89	135	127	129	134	51	127	127	134	134	135	134	90	141	135	106
24	16	20	26	20	16	12	20	20	14	16	16	24	22	24	24	28	20	20	18	16	28	36	28	30	26	24	34	36	24	26	38	30	30	18	20	24	20	22	12	26	24	28	20	26	34	16	26	32	14
94	35	58	124	49	60	34	56	42	33	44	47	95	90	50	103	120	72	65	66	38	90	127	103	118	111	48	130	122	106	103	130	112	130	35	61	57	73	65	13	92	69	97	85	95	123	31	110	111	45
24	16	20	26	20	16	12	20	20	14	16	16	24	22	24	24	28	20	20	18	16	28	36	28	30	26	24	34	36	24	26	38	30	30	18	20	24	20	22	12	26	24	28	20	26	34	16	26	32	14
134	132	100	138	118	129	92	106	123	93	133	110	142	135	107	134	135	126	134	117	124	135	135	141	142	126	122	134	133	143	127	134	135	143	89	135	127	129	134	51	127	127	134	134	135	134	90	141	135	106
24	16	20	26	20	16	12	20	20	14	16	16	24	22	24	24	28	20	20	18	16	28	36	28	30	26	24	34	36	24	26	38	30	30	18	20	24	20	22	12	26	24	28	20	26	34	16	26	32	14
25	17	21	27	21	17	13	21	21	15	17	17	25	23	25	25	29	21	21	19	17	29	37	29	31	27	25	35	37	25	27	39	31	31	19	21	25	21	23	13	27	25	29	21	27	35	17	27	33	15
