26	13	14	8	12	32	18	26	15	16	14	9	9	12	14	21	18	8	14	22	13	20	14	11	12	20	19	13	19	7	2	15	14	16	11	9	9	21	17	16	15	28	3	26	28	18	18	10	24	26
104	73	27	33	33	123	31	97	63	41	99	71	43	25	28	108	39	15	43	64	21	99	134	35	55	118	67	23	68	12	3	101	90	76	64	101	13	51	61	35	69	59	22	98	77	86	82	13	44	115
22	13	14	14	12	32	18	26	15	12	6	9	9	15	18	21	17	8	12	22	13	20	14	11	12	14	8	13	20	7	2	15	14	16	11	9	9	21	17	16	15	20	3	14	20	10	16	10	22	26
30	43	18	16	14	110	22	88	19	14	8	14	28	24	20	59	19	8	20	52	19	39	30	13	13	56	8	23	39	7	2	37	22	38	11	9	9	23	18	32	33	35	3	16	42	10	24	12	66	102
22	13	14	8	12	32	18	26	15	12	6	9	9	12	14	21	17	8	12	22	13	20	14	11	12	14	8	13	19	7	2	15	14	16	11	9	9	21	17	16	15	20	3	14	20	10	16	10	22	26
22	13	14	8	12	32	18	26	15	12	6	9	9	12	14	21	17	8	12	22	13	20	14	11	12	14	8	13	19	7	2	15	14	16	11	9	9	21	17	16	15	20	3	14	20	10	16	10	22	26
22	13	14	8	12	32	18	26	15	12	6	9	9	12	14	21	17	8	12	22	13	20	14	11	12	14	8	13	19	7	2	15	14	16	11	9	9	21	17	16	15	20	3	14	20	10	16	10	22	26
22	13	14	8	12	32	18	26	15	12	6	9	9	12	14	21	17	8	12	22	13	20	14	11	12	14	8	13	19	7	2	15	14	16	11	9	9	21	17	16	15	20	3	14	20	10	16	10	22	26
